Bacsi=Physician
Benhpham=Specimen
butBoqua=       Ignore
butDS_Xem=      View
butGuulaiText=Resend text file
butIn=      Print
butInphieuhen=Print appointment
butKetthuc=      Exit
butLuu=      &Save
butMoi=       &Add
butSua=      &Edit
butXoa=     Delete
Canhbao=Cautions
Cauhinhthongsomayxn=Lab test analyzer parameters
Chaylai=     Re-run
Chinhanh=Branch
Chon=Select
Chualaymau=Not yet collected
cmdDsbenhpham=Specimen list
csbt_nam=Normal values (Male)
csbt_nu=Normal values (Female)
Dacoketqua=Result available
Dain=Printed
Dalaymau=Collected specimens
danhsachcho=Waiting
Denghi=Proposal:
Denngay=and:
Diachi=Address :
Doituong=Pat. class:
Donvi=Unit
dslaymaulai=Re-taken samples
Duketqua=Completed
Duyet=Confirmed
Duyetall=      Approved all
Ghichu=Comments
Goi=Call
Guichidinhvaomayxn=Auto-send data to analysers
Hanhchinh=Demographics
Hovaten=Full name:
Intheoso=Print lab test books
Ketqua=Result
Ketqualanchaytruoc=Previous results
Kqtichluy=       &Accum. Results
KTVXetnghiem=Technician
KTVxntruc=Technician on duty
Lamsang=Symptoms:
Lanlaymau=Collected specimens
Lanvaovien=Admissions
Lietke=List
Lydolaymaulai=Re-taken reasons
Ma=Code
Mabn=Pat. ID
Mauin=Print templates
Mavp=Billing code
MaXN=Code
Ngay=Date:
Ngaychidinh=Ordering date
Ngaygiolaymay=Taken at
Ngaylaymau=Collecting date
NgayLM=Collecting date:
Ngaysinh=DOB:
Nhankqtestfile=Automatically receive result from text file
Nhanvientruc=User
Nhapsothutubp=Entry requirements for specimen number.
Phai=Gender:
phamvi=Result ranges
Phieuketqua=Lab test report
Phieulaymau=Specimen collecting notes
Phieumoi=      &New notes
Phuong=Commune
Quan=District
Quanlyvantay=Fingerprint
Soluong=Qyt
Sophieu=Note #:
Sothe=SSN:
stt=Seq#
STTbenhpham=Specimen #
STTCho=Waiting #
STTTruoc=Previous #
tenkhoaphong=Department
Tenvp=Billing statemen
Tenxn=Lab test
ThemcotKhoaphong=Waiting list
Thoigiankiemtra=Checking time:
Thongtinlaymau=Specimen collecting data
Thumucchuafile=Data directory:
TilePhieuKQ=Lab test report
Tinh=Province
Tinhtrang=Status:
TitlePhieulaymau=Specimen collecting notes
Traketquacn=      Return resuls to sending branch
Truongkhoa=Chief of Lab dept.
Tudongin=Automatically print reports
Tudonginkq=Autoprint
Tudongnhanketqua=Automaatically receive results from analizers
Tungay=Between:
Tuoi=Age :
Tuychon=Options
Tyle=Percentage
Vantay=Fingerprint
Vattuchua=Container
